NO	./textures/placeholder_0.png
EA	./textures/placeholder_1.png
SO	./textures/placeholder_2.png
WE	./textures/placeholder_3.png

C	0,255,255
F	127,63,0

11111
101S1
10101
10001
10111
10001
11111
